WWWWWWWWW
WS000000W
W00WWW00W
W0000000W
W00WWW00W
W0000000W
W00WWW00W
W00000E0W
WWWWWWWWW
