000000000
0S0000000
000000000
000001000
000001000
000001000
000000000
0000000E0
000000000
