000000000
000S00000
000001000
011101110
010000010
010111010
010000010
011101110
00000E000
