WWWWWWWWW
WS0W000EW
W0WW0WWWW
W00W0000W
WW0W0WW0W
W00WWW00W
W0WWW00WW
W0000000W
WWWWWWWWW
