WWWWWWWWW
WS000000W
W0WWW0W0W
W01110W0W
W00000W0W
W01111W0W
W0000000W
W0WWWWE0W
WWWWWWWWW
