WWWWWWWWW
WS00000IW
W0WWW0I0W
W0I0I0I0W
W0I0W0I0W
W0I0I0I0W
W0I0WWI0W
W0IIIIE0W
WWWWWWWWW
