WWWWWWWWW
WS0CC000W
W00W0WC0W
WC0W00C0W
W00WCCC0W
W0CW00CCW
WC0WC000W
W00W000EW
WWWWWWWWW
