WWWWWWWWW
WS      W
W  W WB W
W  W W  W
W  W WW W
W  W    W
WDDWWW  W
W   EW  W
WWWWWWWWW
